Ада́м  в Пятикнижии и Коране — первый человек, сотворенный Богом, и прародитель человеческого рода 

Але́н Фабье́н Мори́с Марсе́ль Дело́н  — французский актер театра и кино, кинорежиссер, сценарист и продюсер 

Алла́х  — арабское слово, означающее единого и единственного Бога-Творца, и господина Судного дня 

Еле́на Все́володовна Сана́ева  — советская и российская актриса театра и кино, общественный деятель; народная артистка Российской Федерации 

Абу́ Абдулла́х аль-Хусе́йн ибн Мансу́р аль-Халла́дж, известный как Мансу́р аль-Халла́дж  — исламский богослов и мистик  родился в Кут , представитель суфизма. 

Андре́й Гео́ргиевич Би́тов  — русский советский писатель, поэт, сценарист, педагог 

Анто́н Па́влович Че́хов  января 1860, Таганрог, Екатеринославская губерния, Российская империя — 2  июля 1904, Баденвайлер, Германская империя) — русский писатель, прозаик, драматург, публицист, врач, общественный деятель в сфере благотворительности 

Хосе́ Анто́нио Доми́нгес Банде́ра , известный в профессиональном плане как Анто́нио Банде́рас  — испанский актер кино, телевидения, мюзиклов и озвучивания, кинорежиссер 

Ариа́дна  — в древнегреческой мифологии прекрасная царевна, дочь критского царя Миноса и Пасифаи 

Джо́рджо Арма́ни  — итальянский модельер и предприниматель, основатель компании Armani, один из богатейших людей Италии. 

Атти́ла  — правитель гуннов в 434—453 годах, объединивший под своей властью тюркские, германские и другие племена, создавший державу, простиравшуюся от Рейна до Волги 

А́нна Андре́евна Ахма́това  — русская и советская поэтесса 

Никола́й Алекса́ндрович Бердя́ев , Кламар) — русский религиозный и политический философ, социолог; представитель русского экзистенциализмa и персонализма 

Уи́льям Сью́ард Бе́рроуз ; 5 февраля 1914 года, Сент-Луис, Миссури, США — 2 августа 1997 года, Лоуренс, Канзас, США) — американский писатель и эссеист 

А́мброз Гуи́ннет Бирс  — американский писатель, журналист, автор юмористических и «страшных» рассказов 

Ро́берт Джо́зеф «Боб» До́ул  — американский политический и партийный деятель, член Республиканской партии, кандидат в президенты США на выборах 1996 года, на которых проиграл демократу Биллу Клинтону 

Бори́с Абра́мович Березо́вский  — советский и российский предприниматель, государственный и политический деятель, ученый-математик, автор ряда научных трудов и монографий, доктор технических наук , профессор 

Бори́с Леони́дович Пастерна́к  1890, Москва, Российская империя — 30 мая 1960, Переделкино, Кунцевский район, Московская область, СССР) — русский советский поэт, писатель и переводчик 

Леони́д Ильи́ч Бре́жнев  — советский государственный, политический и партийный деятель, занимавший высшую руководящую должность в КПСС в течение 18 лет 

Луи́с Бунюэ́ль  Портоле́с  [ˈlwiz βuˈɲwel]; 22 февраля 1900 — 29 июля 1983) — испанский и мексиканский кинорежиссер и сценарист, карьера которого длилась почти пять десятилетий и связана с тремя странами — Испанией, Мексикой и Францией 

Джордж Уо́кер Буш, также известный как Джордж Буш — младший  — американский государственный и политический деятель, 43-й президент США в 2001—2009 годах от Республиканской партии 

Бэ́тмен , изначально Бэт-мен  — персонаж комиксов издательства DC Comics, впервые появившийся в Detective Comics  № 27 в мае 1939 года, Бэтмен является одним из самых популярных и известных героев комиксов 

Баа́л   — является эпитетом «бог, владыка» для разных богов в западносемитской мифологии 

«Generation „П“»  — постмодернистский роман российского писателя Виктора Пелевина о поколении россиян, которое взрослело и формировалось во времена политических и экономических реформ 1990-х годов 

Дие́го Родри́гес де Си́льва-и-Вела́скес  — испанский живописец, крупнейший представитель мадридской школы времен золотого века испанской живописи, придворный художник короля Филиппа IV 

Тит Фла́вий Веспасиа́н , вошедший в историю под именем Веспасиан, — римский император в 69—79 годах, основатель династии Флавиев, пришедший к власти по итогам «года четырех императоров» 

Оле́г  — варяг, правитель Новгородской земли с 879 года и князь Киевский с 882 года 

Влади́мир Ильи́ч Ле́нин  апреля 1870, Симбирск, Российская империя — 21 января 1924, Большие Горки, Сухановская волость, Подольский уезд, Московская губерния, РСФСР, СССР) — российский революционер, адвокат, переводчик, экономист, крупный теоретик марксизма, советский политический и государственный деятель, создатель Российской социал-демократической рабочей партии , один из организаторов и руководителей Октябрьской революции 1917 года в России, первый председатель Совета народных комиссаров РСФСР и Совета народных комиссаров СССР, создатель первого в мировой истории социалистического государства 

Зеэв  Ханин  — израильский политолог, специалист по русскоязычной общине Израиля 

Князь Петр Андре́евич Вя́земский  — русский поэт, литературный критик, историк, переводчик, публицист, мемуарист и государственный деятель 

Ю́рий Алексе́евич Гага́рин  район, Западная область  — 27 марта 1968, возле села Новоселово, Киржачский район, Владимирская область) — летчик-космонавт СССР, Герой Советского Союза, кавалер высших знаков отличия ряда государств, почетный гражданин многих российских и зарубежных городов 

Его́р Тиму́рович Гайда́р  — российский либеральный реформатор, государственный и политический деятель, экономист 

Гамлет — персонаж

Абу́ Джафа́р Хару́н ибн Муха́ммад, более известный как Хару́н ар-Раши́д , Рей, Иран, Аббасидский халифат — 24 марта 809, Тус, Аббасидский халифат) — арабский халиф из династии Аббасидов с 17 сентября 786 по 24 марта 809 года 

Па́уль Йо́зеф Ге́ббельс  — немецкий политик и пропагандист, один из ближайших сподвижников и верных последователей Адольфа Гитлера 

Эрне́сто Че Гева́ра  — аргентинский революционер, команданте Кубинской революции 1959 года и кубинский государственный деятель 

Адо́льф Ги́тлер  — немецкий государственный и политический деятель, один из основоположников национал-социализма, диктатор нацистской Германии с 1933 года до своего самоубийства в 1945 году 

Франси́ско Хосе́ де Го́йя-и-Лусье́нтес  — испанский живописец и график, один из первых и наиболее ярких художников эпохи романтизма. 

Макси́м Го́рький  — русский советский писатель, классик русской литературы, поэт, прозаик, драматург, журналист, общественный деятель и публицист 

Бори́с Бори́сович Гребенщико́в  — советский и российский поэт, музыкант, композитор, певец, гитарист, радиоведущий 

Алекса́ндр Серге́евич Грибое́дов  января 1795, Москва — 30 января  1829, Тегеран) — русский писатель, прозаик, драматург, дипломат, лингвист, историк, востоковед, пианист и композитор 

Филатели́ст — собиратель почтовых марок и других знаков почтовой оплаты, руководствующийся при создании своей коллекции принципами филателии 

Ле́мюэл Гулливе́р  — главный герой романа Джонатана Свифта «Путешествия Гулливера», от лица которого ведется повествование. 

Гэ́ри Ле́онард О́лдмен  — британский актер, режиссер, продюсер и музыкант 

Дарт Ве́йдер , также известный под своим настоящим именем как Энакин Скайуокер  — центральный персонаж первых шести эпизодов саги «Звездные войны» 

Дейл Бре́кенридж Ка́рнеги  — американский педагог, лектор, писатель, оратор-мотиватор 

Кири́лл Алекса́ндрович Толма́цкий , более известный под псевдонимами Децл, Le Truk и Джузеппе Жестко — российский рэп-исполнитель, автор песен, композитор, актер и поэт 

Джордж О́руэлл  — британский писатель, журналист и литературный критик, радиоведущий, автор мемуаров, публицист 

Граф Дра́кула  — вампир, заглавный персонаж и главный антагонист готического романа Брэма Стокера «Дракула» 

Джоха́р Муса́евич Дуда́ев  — чеченский сепаратист, государственный и политический деятель, лидер движения за независимость Чечни от России в 1990-х годах, первый Президент Чеченской Республики Ичкерия 

Дэвид О́гилви  — основатель рекламного агентства Ogilvy, успешный копирайтер 

Алекса́ндр Дюма́  — французский писатель, драматург и журналист 

Бори́с Никола́евич Е́льцин  — советский и российский партийный, государственный и политический деятель, первый Президент Российской Федерации ; в ноябре 1991 — июне 1992 года одновременно возглавлял правительство России 

Серге́й Алекса́ндрович Есе́нин  — русский и советский поэт, писатель 

Леопо́льд фон За́хер-Ма́зох  — австрийско-немецкий писатель 

Генна́дий Андре́евич Зюга́нов  — советский и российский политический деятель 

Ив Анри́ Дона́ Матье Сен-Лора́н  — французский модельер, работавший в мире моды с конца 1950-х до конца 1980-х годов, создатель модного дома Yves Saint Laurent 

Иоа́нн Кроншта́дтский  октября 1829, село Сура, Пинежский уезд, Архангельская губерния — 20 декабря 1908 , Кронштадт, Санкт-Петербургская губерния) — священник Русской православной церкви, митрофорный протоиерей; настоятель Андреевского собора в Кронштадте; член Святейшего правительствующего синода с 1906 года ; «вдохновитель создания и почетный член» Союза русского народа 

Иезекии́ль  — в иудаизме один из трех великих пророков , согласно христианскому учению, один из четырех ветхозаветных великих пророков;  жил в правление иудейского царя Иехонии 

И́штар, Ишта́р, также Эштар, Аштар  — центральное женское божество аккадской мифологии: богиня плодородия и плотской любви, а также войны и распри, астральное божество 

Такубоку Исикава  — японский поэт, литературный критик, оказал сильное влияние на развитие поэзии танка.  

Кибе́ла , в древнегреческой мифологии — богиня, имеющая фригийские корни 

Серге́й Владиле́нович Кирие́нко  — российский государственный деятель 

Кла́удия Мари́я Ши́ффер  — немецкая супермодель, киноактриса, кинопродюсер и посол доброй воли ЮНИСЕФ от Великобритании. 

О́ливер Кро́мвель  1599, Хантингдон, Королевство Англия — 3  сентября 1658, Лондон, Английская республика) — английский государственный, политический и военный деятель, полководец, вождь индепендентов, руководитель Английской революции, в 1643—1650 годах — генерал-лейтенант парламентской армии, в 1650—1653 годах — лорд-генерал, в 1653—1658 годах — лорд-протектор Англии, Шотландии и Ирландии 

Леона́рд Но́рман Ко́эн  — канадский поэт, писатель, певец и автор песен 

Ле́та  — в древнегреческой мифологии источник и одна из пяти рек , протекающих в подземном царстве Аида, река забвения 

Марду́к , иногда Мерода́х  — в шумеро-аккадской мифологии верховное божество пантеона Вавилонии, верховный бог в Древней Месопотамии, бог-покровитель города Вавилона после 2024 г 

Мари́на Ива́новна Цвета́ева  — русская поэтесса Серебряного века, прозаик, переводчица. 

Влади́мир Влади́мирович Маяко́вский  — русский и советский поэт, драматург, киносценарист, кинорежиссер, киноактер, художник 

Граф Мо́нте-Кри́сто — персонаж

Мел Колм-Килле Дже́рард Ги́бсон  — австралийский и американский актер, кинорежиссер, сценарист и продюсер 

О́скар Фи́нгал О’Фла́эрти Уи́ллс Уа́йльд  — ирландский писатель и поэт 

Па́бло Руи́с-и-Пика́ссо  — испанский и французский художник, скульптор, график, театральный художник, керамист и дизайнер 

Алекса́ндр Серге́евич Пу́шкин  — русский поэт, драматург и прозаик, заложивший основы русского реалистического направления, литературный критик и теоретик литературы, историк, публицист, журналист, редактор и издатель 

Григо́рий Ефи́мович Распу́тин  — сибирский крестьянин 

Ро́нальд Уи́лсон Ре́йган  — американский государственный и политический деятель, актер, 40-й президент США  от Республиканской партии 

Арма́н Жан дю Плесси́ де Ришелье , более известный как кардинал Ришелье или Красный кардинал  — французский государственный деятель, центральная фигура эпохи царствования Людовика XIII; кардинал Католической церкви , 1-й герцог де Ришелье , герцог де Фронсак , фактически управлявший Францией в качестве первого министра ; также занимал посты Государственного секретаря по иностранным и военным делам  и губернатора Бретани . 

Роберт Мейнард Пирсиг  — американский писатель и философ, известный главным образом как автор книги «Дзэн и искусство ухода за мотоциклом» , более чем 4 миллиона экземпляров которой было продано по всему миру. 

Лафайе́т Ро́нальд Ха́ббард  — американский писатель-фантаст 

Рональд Макдональд  — клоун, являющийся маскотом компании McDonald’s и истинный основатель компании McDonald’s 

Мстисла́в Леопо́льдович Ростропо́вич  — советский и российский виолончелист, пианист, дирижер, композитор, педагог, общественный деятель; народный артист СССР , лауреат Ленинской премии , Сталинской премии II степени , Государственной премии РФ , Государственной премии РСФСР им 

Салма́н Беты́рович Раду́ев  — военачальник Ичкерии, террорист, один из наиболее известных чеченских военных командиров времен первой и начального этапа второй чеченской войны, бригадный генерал армии ЧРИ , командующий Северо-восточным фронтом  вооруженных сил самопровозглашенной Чеченской Республики Ичкерия, организатор ряда громких терактов на территории Российской Федерации 

Миге́ль де Серва́нтес Сааве́дра , при рождении Миге́ль де Серва́нтес ; около 29 сентября 1547[…], Алькала-де-Энарес — 22 апреля 1616[…], Мадрид) — испанский писатель, драматург и поэт 

Вячесла́в Миха́йлович За́йцев  — советский и российский художник-модельер, живописец и график, кутюрье; народный художник Российской Федерации , лауреат Государственной премии Российской Федерации , профессор, академик Российской академии художеств 

Спаун  — антигерой из одноименного ежемесячного комикса, издаваемого Image Comics 

Ио́сиф Виссарио́нович Ста́лин  — российский революционер, советский политический, государственный, военный и партийный деятель 

Константи́н Серге́евич Станисла́вский  — русский и советский театральный режиссер, актер, педагог, теоретик, реформатор театра 

Сти́вен Э́двин Кинг  — американский писатель, работающий в разнообразных жанрах, включая ужасы, триллер, фантастику, фэнтези, мистику, драму, детектив, получил прозвище «Король ужасов» 

Лев Дави́дович Тро́цкий  1879, Яновка, Херсонская губерния, Российская империя — 21 августа 1940, Койоакан, Мексика) — российский революционер, активный участник российского и международного социалистического и коммунистического движения, советский государственный, партийный и военно-политический деятель, основатель и идеолог троцкизма 

Федор Ива́нович Тю́тчев  — русский поэт-мыслитель, лирик, переводчик, дипломат и чиновник , консервативный публицист. 

Федор Миха́йлович Достое́вский  — русский писатель, мыслитель, философ и публицист 

Фре́дди Ме́ркьюри ; 5 сентября 1946[…], Занзибар — 24 ноября 1991[…], Кенсингтон, Большой Лондон) — британский рок-певец, композитор и автор песен парсийского происхождения 

Премия центра Кеннеди  — это ежегодная премия, вручаемая лицам, занимающимся исполнительским искусством, за их вклад в развитие американской культуры 

Петр Я́ковлевич Чаада́ев  — русский философ  и публицист 

Чарльз Миллз Мэ́нсон , фамилия при рождении — Мэ́ддокс  — американский серийный убийца, преступник, создатель и руководитель общины, которая называла себя «Семьей» и по официальной версии прокуратуры США являлась деструктивной сектой, члены которой в 1969 году, подчиняясь приказам Мэнсона, совершили ряд жестоких убийств, в том числе убили беременную актрису Шэрон Тейт 

Ви́ктор Степа́нович Черномы́рдин  — советский и российский государственный деятель 

Анато́лий Бори́сович Чуба́йс  — советский и российский политический, государственный и хозяйственный деятель, экономист, кандидат экономических наук 

Уи́льям Шекспи́р ]; 26 апреля 1564 года , Стратфорд-апон-Эйвон, Англия — 23 апреля  1616, там же) — английский поэт и драматург, зачастую считается величайшим англоязычным писателем и одним из лучших драматургов мира 

Альбе́рт Эйнште́йн  — швейцарский, немецкий и американский физик-теоретик и общественный деятель-гуманист, один из основателей современной теоретической физики 

Эл Райс  — американский маркетолог, писатель, соучредитель и председатель консалтинговой фирмы «Ries & Ries» 

Э́нди Уо́рхол  — американский художник, продюсер, дизайнер, писатель, издатель журналов и кинорежиссер русинского происхождения, заметная персона в истории поп-арт-движения и современного искусства в целом 

Энкиду  — в шумеро-аккадской мифологии — герой, соратник и друг Гильгамеша, его побратим, созданный богиней Аруру по просьбе богов как соперник Гильгамеша 

Валенти́н Абра́мович Юда́шкин  — советский и российский художник-модельер, дизайнер, кутюрье, телеведущий и главный редактор 

Григо́рий Алексе́евич Явли́нский  — советский и российский государственный и политический деятель, заместитель Председателя Совета министров РСФСР , экономист, бывший депутат Государственной думы 

Эрне́сто Че Гева́ра  — аргентинский революционер, команданте Кубинской революции 1959 года и кубинский государственный деятель 

Донасье́н Альфо́нс Франсуа́ де Сад , известный как марки́з де Сад  — французский аристократ, политик, писатель и философ и судья 

